width: 10
height: 10
person: 5 5

##########
#________#
##_______#
#________#
#________#
#________#
#________#
#_____####
#________#
##########