8
#
.
^
############
#.........##
#....##.#.^
##.########
#..#......#
####...####
   #....#
   ######